"filename", "language", "Python", "comment", "blank", "total"
"d:\Seafile\Jamming\global_var.py", "Python", 13, 0, 2, 15
"d:\Seafile\Jamming\main.py", "Python", 124, 45, 28, 197
"d:\Seafile\Jamming\settings.py", "Python", 25, 1, 5, 31
"d:\Seafile\Jamming\test.py", "Python", 2, 42, 8, 52
"d:\Seafile\Jamming\tests\io_with_no_block_pyaudio.py", "Python", 192, 41, 46, 279
"d:\Seafile\Jamming\tests\io_with_spi.py", "Python", 74, 5, 11, 90
"d:\Seafile\Jamming\tests\test_LMS.py", "Python", 90, 32, 25, 147
"d:\Seafile\Jamming\tests\test_LTI.py", "Python", 21, 7, 9, 37
"d:\Seafile\Jamming\tests\test_align.py", "Python", 18, 0, 5, 23
"d:\Seafile\Jamming\tests\test_all_devices.py", "Python", 6, 2, 2, 10
"d:\Seafile\Jamming\tests\test_anc.py", "Python", 164, 48, 36, 248
"d:\Seafile\Jamming\tests\test_anc2.py", "Python", 191, 70, 40, 301
"d:\Seafile\Jamming\tests\test_anc3.py", "Python", 57, 21, 14, 92
"d:\Seafile\Jamming\tests\test_anc4.py", "Python", 145, 24, 31, 200
"d:\Seafile\Jamming\tests\test_bit.py", "Python", 11, 0, 1, 12
"d:\Seafile\Jamming\tests\test_fft.py", "Python", 76, 9, 25, 110
"d:\Seafile\Jamming\tests\test_io.py", "Python", 36, 14, 13, 63
"d:\Seafile\Jamming\tests\test_kws.py", "Python", 29, 64, 18, 111
"d:\Seafile\Jamming\tests\test_locate.py", "Python", 47, 7, 16, 70
"d:\Seafile\Jamming\tests\test_modulate.py", "Python", 17, 8, 8, 33
"d:\Seafile\Jamming\tests\test_mutation.py", "Python", 26, 29, 12, 67
"d:\Seafile\Jamming\tests\test_no_linear.py", "Python", 15, 19, 9, 43
"d:\Seafile\Jamming\tests\test_npy.py", "Python", 9, 12, 11, 32
"d:\Seafile\Jamming\tests\test_numba.py", "Python", 33, 22, 13, 68
"d:\Seafile\Jamming\tests\test_pool.py", "Python", 18, 26, 20, 64
"d:\Seafile\Jamming\tests\test_pyaudio.py", "Python", 110, 6, 31, 147
"d:\Seafile\Jamming\tests\test_ring_effect.py", "Python", 61, 46, 29, 136
"d:\Seafile\Jamming\tests\test_spec_sub.py", "Python", 50, 28, 12, 90
"d:\Seafile\Jamming\tests\test_spectrum.py", "Python", 48, 2, 6, 56
"d:\Seafile\Jamming\tests\test_stft.py", "Python", 24, 28, 13, 65
"d:\Seafile\Jamming\tests\test_threads.py", "Python", 23, 0, 9, 32
"d:\Seafile\Jamming\tests\test_wav.py", "Python", 4, 5, 1, 10
"d:\Seafile\Jamming\threads\anc.py", "Python", 168, 64, 27, 259
"d:\Seafile\Jamming\threads\io.py", "Python", 118, 18, 18, 154
"d:\Seafile\Jamming\threads\kws.py", "Python", 64, 7, 8, 79
"d:\Seafile\Jamming\threads\nl.py", "Python", 70, 85, 22, 177
"d:\Seafile\Jamming\utils\access.py", "Python", 59, 5, 12, 76
"d:\Seafile\Jamming\utils\codec.py", "Python", 67, 15, 12, 94
"d:\Seafile\Jamming\utils\iters.py", "Python", 11, 1, 2, 14
"d:\Seafile\Jamming\utils\mfft.py", "Python", 57, 8, 9, 74
"d:\Seafile\Jamming\utils\mfilter.py", "Python", 15, 2, 4, 21
"d:\Seafile\Jamming\utils\modulate.py", "Python", 143, 39, 37, 219
"d:\Seafile\Jamming\utils\mplot.py", "Python", 126, 0, 14, 140
"d:\Seafile\Jamming\utils\pool.py", "Python", 148, 13, 40, 201
"d:\Seafile\Jamming\utils\resampler.py", "Python", 10, 7, 4, 21
"d:\Seafile\Jamming\utils\statistics.py", "Python", 128, 37, 19, 184
"Total", "-", 2943, 964, 737, 4644